********
*      *
*      *
*  **  *
*      *
*      *
*      *
********