********
*      *
*      *
* **   *
*   ** *
*      *
*      *
********