********
*      *
*      *
* **   *
*  *   *
*      *
*      *
********