*#*#*#*#
#      *
*  *   #
# * *  #
*  *   *
#      #
*      *
*#*#*#*#