*#*#*#*#
#      *
*      #
# *#   #
*   *# *
#      #
*      *
*#*#*#*#