*#*#*##*#*#*##*#*#*##
#                   *
*  *                #
*  *$       S       *
*  *                #
*                *  #
*#*#*##*#*#*##*#*#*##