*#*#*##*#*#*##*#*#*##
#                   *
*  *                #
*  *      S         *
*  *                #
*                *  #
*                *  #
*#*#*##*#*#*##*#*#*##