*#*#*##*#*#*##*#*#*##
#                   *
*  *                #
*  *  $     S       *
*  *                #
*                *  #
*#*#*##*#*#*##*#*#*##