*#*#*##*#*#*##*#*#*##
#  S                *
*  *                #
*  *                *
*  *                #
*                *  #
*                *  #
*#*#*##*#*#*##*#*#*##