**************************************************************************************************************************
*  S   *  *                                                *      *                                                 #    #
*      *  ***  *********************#                      *      *                                                 ######
*      *  ***  *********************#    *       *         *      *                                ####                  #
*      *  * *  *  *  *  *  *  *    *#   ***     ***        *      *                                #  #             ###  #
*** ****  *                        **    *       *         *      *                   ####         #  #               #  #
* * *     * *  *  *  *  *  *  *    *#                      *      *                   #  #         ####               #  #
* * *     *                        *#                      *      *      ####         #  #                            #  #
* * *     **********************   *#    *       *         *      *      #  #         ####                            #  #
*** ****************************   *#   ***     ***        *      *      #  #                                         #  #
*                      *********   *#    *       *         ********      ####                                         #  #
*                      *********   *#                                                                                 #  #
*                      *********   *###############################                                                   #  #
*                      *********   ***********************************************************************************####
*                      *********   ***********************************************************************************####
*                                  ***********************************************************************************####
*                                  ***********************************************************************************####
*                      ***********************************************************************************************####
**************************************************************************************************************************