##############
##           #
##           #
##           #
##           #
##    S      #
##           #
##           #
##           #
##############