*************************************************************************************************************************
*S        *     * * *     *     *           *     *     *   *   *   *         *   *   *   *         * *             * * *
*** * ******* *** * ***** * *** * ********* * * * *** * *** * *** * * ***** *** ***** *** * *** * *** *********** *** * *
* * * *       *     * * *   * *     *   *   * * * *   * *     *   * * *     * *             *   * * *   *   *     *   * *
* * *** *** * * * *** * ***** ***** * * ***** ***** ******* ***** ***** *** * * *** * * *** *** *** * ***** *** *** * * *
*         * * * *     * *   * *   *   *   * *       *       * *       *   * *     * * *   * *     *   * * *   *     * * *
*** ******* *** ******* *** * * * * *** * * * *** * * *** *** *** ******* * *** ***** ***** ******* *** * *** * ******* *
* *       * * * *   *           * * *   *   * *   * * *   *           * * * *       *   *   *   *     *         * *     *
* * ******* * * *** ***** * * * * ******* *** ********* ******* ***** * * *** * * *** ******* *** * ***** *** *** *** ***
*       *         *   * * * * * *                   *       *     * * * *     * * *       *   *   * * *   * * *   * *   *
*** *** *** *** *** *** *** * * * *************** * * *** *** *** * * * *** ************* * ******* * * *** * * * * * ***
*     * *     *     *       * * *         *     * * * * *       * *     *   *         *   *         *     *     *       *
* * ***** ********* ***** ******* *** * ***** * *** * * *** * *********** ***** *** * * ***** ***** ***** ******* * *****
* *   * * *   * *   *         * * *   *   *   *     * *     * * *   *           *   * *   *     *   *   * *       * *   *
*** * * *** *** *** *** * *** * * ******* *** * ************* * * * *********** ***************** * * *** * *********** *
* * * *   *       *     * *     * * *     *   *   *   *     * * * * *                       *     *   *   *   *     *   *
* * *** * * ***** * ********* * *** ***** * ***** * * ***** * * *** * *** ***** * * ***** ********* ******* * * * *** ***
* *   * *     *       *       *       *   *     * * *   * *   *       *     *   * *     * *     *   * *   * *   *     * *
* ***** ***** *** * * ***************** * ***** ***** * * * ***** *** *** * ***** *** * *** * ***** * *** * * * * * *** *
* *       *   * * * *     * *         * *   * * *   * *     * * * *     * * *   *   * *     *         * *   * * * *     *
* *** ******* * * ********* * *** ***** ***** *** *** *** *** * ***** *** * *** * ***** *********** *** *** *********** *
* * *     * * * *   *   * * *   *   *     * * *   * * * *       *     * * * *     *       *   *         *       * *     *
* * * *** * * * * *** *** * * ********* * * * * *** * * *** *** * ***** *** ********* *** * * *** ******* ******* *******
*     *     *   *   *     *     *       * *     *   * * * * *   * *   *     *     *   *     *   * * *       * *   *     *
* * * ********* * * *** *** * * *** ***** * ******* *** * * ******* ***** * *** ************* ***** *** ***** *** * * * *
* * * *   * * * * *   *     * * *     *       *                 *   *   * *         * * *   *   * *       *         * * *
* * ***** * * * * *** ***** ***** ***************** *** * ***** *** * * *** *** ***** * *** * *** ***** * * *** * * *****
* *     *     * * * * *   * *       * * *   * *       * *     * *     *   * *         * *   *       *   * * * * * * *   *
***** * *** * * * * *** *** ******* * * *** * * ***** ***** *** *** *** * * ***** ***** * *** * * * * ******* *** *** ***
*     *   * * * * *   * * *       *   *   *   *   * *     *   *   *   * * * *             * * * * * *   * *         *   *
* ******* * ***** * *** * *** *** *** * * *** *** * ***** ***** *** * * * ***** *** * *** * * ***** * * * ***** * *** ***
* * *           * *   *     *   * * *   * *       *   *       *     * * *       *   * *     *     *   * *       *   *   *
* * *** ***** * * * ***** * * ***** ***** ***** * * * *** * * * ***** ***** * * * *** *** ********* * * *** * *** ***** *
*   *       * * * *   *   *   *     *   * *     * * * *   * * * * * *   *   * * * * * *       * *   * *     *   *       *
* * *** *** * ***** * * ***** *** *** * * *** *** *** * *** * *** * * * ***** *** * *** ***** * ******* ***** ******* * *
* * * *   * *       * *     *         * *     *   * *     * * *     * *   * * *   *   *   *     *     * *           * * *
*** * * * * *** *** ***** * ***** *** * *** ******* *** *** ******* * * *** ***** *** *** * ********* ***** * *** ***** *
*   * * * *   * *     *   * *   *   * *   * * *   * *     *   * *     *       *         * *   *       * *   * *   *     *
* *** ***** * * * ***** ******* * *** *** * * *** * *** *** * * * *********** * * ********* ***** *** * * ************* *
*   *     * * * *   * * *     *   *   *     * *       * *   * *   *     *   * * * *       *   * * *   *         * *     *
* ******* * * * ***** ******* ***** *** *** * *** ******* ******* * *** *** ***** ***** * *** * ***** * * ***** * ***** *
* *       * * *     * *     *   *   *     *   *   *     *   *         *   * *   * *   * *       *     * *   *     *     *
* ***** *** ******* * *** * *** * ******* ***** * *** *** *** * *** * ***** *** ***** ***** ******* ******* * * ***** ***
* *   *   *   * * * *     * *       * *   *   * *   *     * * * *   *         * *   *   *   * *   *   *     * *   *     *
* *** * *** *** * * *** * * * ***** * * ***** ***** * * * * *** * * ***** ***** *** *** * * * *** *** ******* ***** *****
* *     * * *   * * *   * * *   *     *     * *       * * *     * * *   *   *   *       * *                 *   * * *   *
***** *** *** * * ********* ******* ********* ******* ***** * ********* * * * ***** *** * * *** *** * * *** ***** *** * *
*     *       *     *   *     *   *   * *   *         * *   *     *     * *           * * * * * *   * * * * *         * *
* *** ********* * ***** * ***** ******* * * ******* *** * ********* * * ***** * *** ***** *** ***** ***** * ******* *** *
* *       *     *   *                 *   *   * *   *       *   *   * * * * * * *     *     *     * * *     *   *   *   *
********* ******* * * *** * * ********* * * * * *** * ***** * *** * *** * * * *** ***** *** * *** *** * * * * *** *** ***
*   *     *   * * * *   * * *       *   * * *     * *   * *   * * * *       * *     * *   * *   *       * * *   *   * * *
* * ***** *** * *** * ********* ************* * * * *** * *** * ******* ********* *** * ******* *** ***** * * * *** * * *
* * *     *             *   * *     * *     * * *   *   * *   *   *   * *         *   * *   *   *       * *   * * * *   *
* ***** *** * ******* *** * * *** *** * ************* *** * ***** *** * * *** ******* * *** ********* * ***** *** ***** *
*   * *     * * *     * * *       * *   *           * * *   * *     *       * *     * * * *     *     *   *   *         *
*** * * * ***** ***** * ***** ***** *** * *** * * *** * ***** * ******* ***** ***** * * * * * *** ***** *** ********* ***
*       *   *     * * * * * *       *   * * * * *     *   *   * *     *   *   * *     *   * *   *   *   *       *   * * *
* * ******* * *** * *** * * * *** *** ***** * ***** * * *** * * * ************* *** * * ******* ************* ***** * * *
* * *   * * * *   *   *     * * *     * * *     * * * *     *       *   * *     *   * *     *   *   *       * * *   * * *
***** * * * * * *** * ***** * * ******* * *** *** * * *** ***** ***** *** * * ***** ***** * * ***** * ******* * * * * * *
* *   *     * *     * *       * * *   *       *     * *       *             *     * *     *     *   *       *   * *   * *
* *** *** * * * ******* ******* * * ***** * ***** *********** * ***** * *** *** *** * *** * * *** * ***** *** *** * *** *
* *     * *   *   *     *     *           *   * * *     * *   * *   * * *   * * *       * * *     * * * * *   * * *     *
* ************* * * ******* *** *** ***** ***** * * ***** *** ***** ***** *** *** *** ******* ***** * * * * *** ***** ***
*   * *     * * * * *   *     *   *     * *                 *       *       *     * * *       *       *     * *   * *   *
* * * ***** * * *** * ******* *** *********** * * *** *** ******* *** * *** *** * * ******************* * * * * *** * * *
* *       *     *       *   * *   * * *       * *   *   * * * * * *   * *       * * *   * * * * *       * *           * *
*** ***** *** ***** *** *** * * * * * * * * * * * * * ***** * * *** *** *** * *** * * *** * * * *** *********** * * * ***
* *   *     *   *   *   *     * *     * * * * * * * *   * * *         *   * * *   * *   *     *   * *           * * *   *
* * *** ******* *** ***** * * ***** * *** * ******* *** * * * ***** * ********* *** * ******* * * * ******* * * * * * ***
* * *   *       * *     * * * *   * *   * *   *       * *       *   * *     * *   *   * *     * * *   * *   * * * * *   *
* * *** ***** * * * * * * * *** ***** *** * ******* * * * *** *** *** * * *** *** * * * *** ***** * * * ******* *********
*     *   *   *   * * *   *     *     * * *     *   * * * *     * * *   *   *     * *   *     *     *         *         *
********* * * ******* ************* *** * ***** ******* * ******* * *** *** ***** *** ******* *** * ******* ***** * * * *
*   * *     *       * *   * *   * * *   *   *         * *     *   * *     * * * *       *   * * * *     * *   *   * * * *
*** * *** *********** *** * * * * * * * * ***** * ******* * ***** * * * * *** * * ***** * * * * * * * *** *** * ***** ***
* *   *   *     *             * *     * *   * * *   *     *   * * *   * * *     *     *   * *     * * * * *   *   *     *
* * * *** *** * *** * *** * * * * *** *** * * * * * ***** * *** *** * *** * ***** ******* ******* * *** * * *** * *** ***
*   *         *   * * *   * * *     * *   *   * * *   *   *       * * *       *     *         *   *       * *   * *    #*
*************************************************************************************************************************