+-+-+-+-+-+-+-+-+-+-+-+-+-+-+-+-+-+-+-+-+-+-+-+-+-+-+-+-+-+-+-+-+-+-+-+-+-+-+-+-+-+-+-+-+-+-+-+-+-+-+-+-+-+-+-+-+-+-+-+-+
|S        |     | | |     |     |           |     |     |   |   |   |         |   |   |   |         | |             | | |
+-+ + +-+-+-+ +-+ + +-+-+ + +-+ + +-+-+-+-+ + + + +-+ + +-+ + +-+ + + +-+-+ +-+ +-+-+ +-+ + +-+ + +-+ +-+-+-+-+-+ +-+ + +
| | | |       |     | | |   | |     |   |   | | | |   | |     |   | | |     | |             |   | | |   |   |     |   | |
+ + +-+ +-+ + + + +-+ + +-+-+ +-+-+ + + +-+-+ +-+-+ +-+-+-+ +-+-+ +-+-+ +-+ + + +-+ + + +-+ +-+ +-+ + +-+-+ +-+ +-+ + + +
|         | | | |     | |   | |   |   |   | |       |       | |       |   | |     | | |   | |     |   | | |   |     | | |
+-+ +-+-+-+ +-+ +-+-+-+ +-+ + + + + +-+ + + + +-+ + + +-+ +-+ +-+ +-+-+-+ + +-+ +-+-+ +-+-+ +-+-+-+ +-+ + +-+ + +-+-+-+ +
| |       | | | |   |           | | |   |   | |   | | |   |           | | | |       |   |   |   |     |         | |     |
+ + +-+-+-+ + + +-+ +-+-+ + + + + +-+-+-+ +-+ +-+-+-+-+ +-+-+-+ +-+-+ + + +-+ + + +-+ +-+-+-+ +-+ + +-+-+ +-+ +-+ +-+ +-+
|       |         |   | | | | | |                   |       |     | | | |     | | |       |   |   | | |   | | |   | |   |
+-+ +-+ +-+ +-+ +-+ +-+ +-+ + + + +-+-+-+-+-+-+-+ + + +-+ +-+ +-+ + + + +-+ +-+-+-+-+-+-+ + +-+-+-+ + + +-+ + + + + + +-+
|     | |     |     |       | | |         |     | | | | |       | |     |   |         |   |         |     |     |       |
+ + +-+-+ +-+-+-+-+ +-+-+ +-+-+-+ +-+ + +-+-+ + +-+ + + +-+ + +-+-+-+-+-+ +-+-+ +-+ + + +-+-+ +-+-+ +-+-+ +-+-+-+ + +-+-+
| |   | | |   | |   |         | | |   |   |   |     | |     | | |   |           |   | |   |     |   |   | |       | |   |
+-+ + + +-+ +-+ +-+ +-+ + +-+ + + +-+-+-+ +-+ + +-+-+-+-+-+-+ + + + +-+-+-+-+-+ +-+-+-+-+-+-+-+-+ + + +-+ + +-+-+-+-+-+ +
| | | |   |       |     | |     | | |     |   |   |   |     | | | | |                       |     |   |   |   |     |   |
+ + +-+ + + +-+-+ + +-+-+-+-+ + +-+ +-+-+ + +-+-+ + + +-+-+ + + +-+ + +-+ +-+-+ + + +-+-+ +-+-+-+-+ +-+-+-+ + + + +-+ +-+
| |   | |     |       |       |       |   |     | | |   | |   |       |     |   | |     | |     |   | |   | |   |     | |
+ +-+-+ +-+-+ +-+ + + +-+-+-+-+-+-+-+-+ + +-+-+ +-+-+ + + + +-+-+ +-+ +-+ + +-+-+ +-+ + +-+ + +-+-+ + +-+ + + + + + +-+ +
| |       |   | | | |     | |         | |   | | |   | |     | | | |     | | |   |   | |     |         | |   | | | |     |
+ +-+ +-+-+-+ + + +-+-+-+-+ + +-+ +-+-+ +-+-+ +-+ +-+ +-+ +-+ + +-+-+ +-+ + +-+ + +-+-+ +-+-+-+-+-+ +-+ +-+ +-+-+-+-+-+ +
| | |     | | | |   |   | | |   |   |     | | |   | | | |       |     | | | |     |       |   |         |       | |     |
+ + + +-+ + + + + +-+ +-+ + + +-+-+-+-+ + + + + +-+ + + +-+ +-+ + +-+-+ +-+ +-+-+-+-+ +-+ + + +-+ +-+-+-+ +-+-+-+ +-+-+-+
|     |     |   |   |     |     |       | |     |   | | | | |   | |   |     |     |   |     |   | | |       | |   |     |
+ + + +-+-+-+-+ + + +-+ +-+ + + +-+ +-+-+ + +-+-+-+ +-+ + + +-+-+-+ +-+-+ + +-+ +-+-+-+-+-+-+ +-+-+ +-+ +-+-+ +-+ + + + +
| | | |   | | | | |   |     | | |     |       |                 |   |   | |         | | |   |   | |       |         | | |
+ + +-+-+ + + + + +-+ +-+-+ +-+-+ +-+-+-+-+-+-+-+-+ +-+ + +-+-+ +-+ + + +-+ +-+ +-+-+ + +-+ + +-+ +-+-+ + + +-+ + + +-+-+
| |     |     | | | | |   | |       | | |   | |       | |     | |     |   | |         | |   |       |   | | | | | | |   |
+-+-+ + +-+ + + + + +-+ +-+ +-+-+-+ + + +-+ + + +-+-+ +-+-+ +-+ +-+ +-+ + + +-+-+ +-+-+ + +-+ + + + + +-+-+-+ +-+ +-+ +-+
|     |   | | | | |   | | |       |   |   |   |   | |     |   |   |   | | | |             | | | | | |   | |         |   |
+ +-+-+-+ + +-+-+ + +-+ + +-+ +-+ +-+ + + +-+ +-+ + +-+-+ +-+-+ +-+ + + + +-+-+ +-+ + +-+ + + +-+-+ + + + +-+-+ + +-+ +-+
| | |           | |   |     |   | | |   | |       |   |       |     | | |       |   | |     |     |   | |       |   |   |
+ + +-+ +-+-+ + + + +-+-+ + + +-+-+ +-+-+ +-+-+ + + + +-+ + + + +-+-+ +-+-+ + + + +-+ +-+ +-+-+-+-+ + + +-+ + +-+ +-+-+ +
|   |       | | | |   |   |   |     |   | |     | | | |   | | | | | |   |   | | | | | |       | |   | |     |   |       |
+ + +-+ +-+ + +-+-+ + + +-+-+ +-+ +-+ + + +-+ +-+ +-+ + +-+ + +-+ + + + +-+-+ +-+ + +-+ +-+-+ + +-+-+-+ +-+-+ +-+-+-+ + +
| | | |   | |       | |     |         | |     |   | |     | | |     | |   | | |   |   |   |     |     | |           | | |
+-+ + + + + +-+ +-+ +-+-+ + +-+-+ +-+ + +-+ +-+-+-+ +-+ +-+ +-+-+-+ + + +-+ +-+-+ +-+ +-+ + +-+-+-+-+ +-+-+ + +-+ +-+-+ +
|   | | | |   | |     |   | |   |   | |   | | |   | |     |   | |     |       |         | |   |       | |   | |   |     |
+ +-+ +-+-+ + + + +-+-+ +-+-+-+ + +-+ +-+ + + +-+ + +-+ +-+ + + + +-+-+-+-+-+ + + +-+-+-+-+ +-+-+ +-+ + + +-+-+-+-+-+-+ +
|   |     | | | |   | | |     |   |   |     | |       | |   | |   |     |   | | | |       |   | | |   |         | |     |
+ +-+-+-+ + + + +-+-+ +-+-+-+ +-+-+ +-+ +-+ + +-+ +-+-+-+ +-+-+-+ + +-+ +-+ +-+-+ +-+-+ + +-+ + +-+-+ + + +-+-+ + +-+-+ +
| |       | | |     | |     |   |   |     |   |   |     |   |         |   | |   | |   | |       |     | |   |     |     |
+ +-+-+ +-+ +-+-+-+ + +-+ + +-+ + +-+-+-+ +-+-+ + +-+ +-+ +-+ + +-+ + +-+-+ +-+ +-+-+ +-+-+ +-+-+-+ +-+-+-+ + + +-+-+ +-+
| |   |   |   | | | |     | |       | |   |   | |   |     | | | |   |         | |   |   |   | |   |   |     | |   |     |
+ +-+ + +-+ +-+ + + +-+ + + + +-+-+ + + +-+-+ +-+-+ + + + + +-+ + + +-+-+ +-+-+ +-+ +-+ + + + +-+ +-+ +-+-+-+ +-+-+ +-+-+
| |     | | |   | | |   | | |   |     |     | |       | | |     | | |   |   |   |       | |                 |   | | |   |
+-+-+ +-+ +-+ + + +-+-+-+-+ +-+-+-+ +-+-+-+-+ +-+-+-+ +-+-+ + +-+-+-+-+ + + + +-+-+ +-+ + + +-+ +-+ + + +-+ +-+-+ +-+ + +
|     |       |     |   |     |   |   | |   |         | |   |     |     | |           | | | | | |   | | | | |         | |
+ +-+ +-+-+-+-+ + +-+-+ + +-+-+ +-+-+-+ + + +-+-+-+ +-+ + +-+-+-+-+ + + +-+-+ + +-+ +-+-+ +-+ +-+-+ +-+-+ + +-+-+-+ +-+ +
| |       |     |   |                 |   |   | |   |       |   |   | | | | | | |     |     |     | | |     |   |   |   |
+-+-+-+-+ +-+-+-+ + + +-+ + + +-+-+-+-+ + + + + +-+ + +-+-+ + +-+ + +-+ + + + +-+ +-+-+ +-+ + +-+ +-+ + + + + +-+ +-+ +-+
|   |     |   | | | |   | | |       |   | | |     | |   | |   | | | |       | |     | |   | |   |       | | |   |   | | |
+ + +-+-+ +-+ + +-+ + +-+-+-+-+ +-+-+-+-+-+-+ + + + +-+ + +-+ + +-+-+-+ +-+-+-+-+ +-+ + +-+-+-+ +-+ +-+-+ + + + +-+ + + +
| | |     |             |   | |     | |     | | |   |   | |   |   |   | |         |   | |   |   |       | |   | | | |   |
+ +-+-+ +-+ + +-+-+-+ +-+ + + +-+ +-+ + +-+-+-+-+-+-+ +-+ + +-+-+ +-+ + + +-+ +-+-+-+ + +-+ +-+-+-+-+ + +-+-+ +-+ +-+-+ +
|   | |     | | |     | | |       | |   |           | | |   | |     |       | |     | | | |     |     |   |   |         |
+-+ + + + +-+-+ +-+-+ + +-+-+ +-+-+ +-+ + +-+ + + +-+ + +-+-+ + +-+-+-+ +-+-+ +-+-+ + + + + + +-+ +-+-+ +-+ +-+-+-+-+ +-+
|       |   |     | | | | | |       |   | | | | |     |   |   | |     |   |   | |     |   | |   |   |   |       |   | | |
+ + +-+-+-+ + +-+ + +-+ + + + +-+ +-+ +-+-+ + +-+-+ + + +-+ + + + +-+-+-+-+-+-+ +-+ + + +-+-+-+ +-+-+-+-+-+-+ +-+-+ + + +
| | |   | | | |   |   |     | | |     | | |     | | | |     |       |   | |     |   | |     |   |   |       | | |   | | |
+-+-+ + + + + + +-+ + +-+-+ + + +-+-+-+ + +-+ +-+ + + +-+ +-+-+ +-+-+ +-+ + + +-+-+ +-+-+ + + +-+-+ + +-+-+-+ + + + + + +
| |   |     | |     | |       | | |   |       |     | |       |             |     | |     |     |   |       |   | |   | |
+ +-+ +-+ + + + +-+-+-+ +-+-+-+ + + +-+-+ + +-+-+ +-+-+-+-+-+ + +-+-+ + +-+ +-+ +-+ + +-+ + + +-+ + +-+-+ +-+ +-+ + +-+ +
| |     | |   |   |     |     |           |   | | |     | |   | |   | | |   | | |       | | |     | | | | |   | | |     |
+ +-+-+-+-+-+-+ + + +-+-+-+ +-+ +-+ +-+-+ +-+-+ + + +-+-+ +-+ +-+-+ +-+-+ +-+ +-+ +-+ +-+-+-+ +-+-+ + + + + +-+ +-+-+ +-+
|   | |     | | | | |   |     |   |     | |                 |       |       |     | | |       |       |     | |   | |   |
+ + + +-+-+ + + +-+ + +-+-+-+ +-+ +-+-+-+-+-+ + + +-+ +-+ +-+-+-+ +-+ + +-+ +-+ + + +-+-+-+-+-+-+-+-+-+ + + + + +-+ + + +
| |       |     |       |   | |   | | |       | |   |   | | | | | |   | |       | | |   | | | | |       | |           | |
+-+ +-+-+ +-+ +-+-+ +-+ +-+ + + + + + + + + + + + + + +-+-+ + + +-+ +-+ +-+ + +-+ + + +-+ + + + +-+ +-+-+-+-+-+ + + + +-+
| |   |     |   |   |   |     | |     | | | | | | | |   | | |         |   | | |   | |   |     |   | |           | | |   |
+ + +-+ +-+-+-+ +-+ +-+-+ + + +-+-+ + +-+ + +-+-+-+ +-+ + + + +-+-+ + +-+-+-+-+ +-+ + +-+-+-+ + + + +-+-+-+ + + + + + +-+
| | |   |       | |     | | | |   | |   | |   |       | |       |   | |     | |   |   | |     | | |   | |   | | | | |   |
+ + +-+ +-+-+ + + + + + + + +-+ +-+-+ +-+ + +-+-+-+ + + + +-+ +-+ +-+ + + +-+ +-+ + + + +-+ +-+-+ + + + +-+-+-+ +-+-+-+-+
|     |   |   |   | | |   |     |     | | |     |   | | | |     | | |   |   |     | |   |     |     |         |         |
+-+-+-+-+ + + +-+-+-+ +-+-+-+-+-+-+ +-+ + +-+-+ +-+-+-+ + +-+-+-+ + +-+ +-+ +-+-+ +-+ +-+-+-+ +-+ + +-+-+-+ +-+-+ + + + +
|   | |     |       | |   | |   | | |   |   |         | |     |   | |     | | | |       |   | | | |     | |   |   | | | |
+-+ + +-+ +-+-+-+-+-+ +-+ + + + + + + + + +-+-+ + +-+-+-+ + +-+-+ + + + + +-+ + + +-+-+ + + + + + + + +-+ +-+ + +-+-+ +-+
| |   |   |     |             | |     | |   | | |   |     |   | | |   | | |     |     |   | |     | | | | |   |   |     |
+ + + +-+ +-+ + +-+ + +-+ + + + + +-+ +-+ + + + + + +-+-+ + +-+ +-+ + +-+ + +-+-+ +-+-+-+ +-+-+-+ + +-+ + + +-+ + +-+ +-+
|   |         |   | | |   | | |     | |   |   | | |   |   |       | | |       |     |         |   |       | |   | |    X|
+-+-+-+-+-+-+-+-+-+-+-+-+-+-+-+-+-+-+-+-+-+-+-+-+-+-+-+-+-+-+-+-+-+-+-+-+-+-+-+-+-+-+-+-+-+-+-+-+-+-+-+-+-+-+-+-+-+-+-+-+